那	哪
怒	恕
扞	捍
噎	饐
仙	僊	仚	屳	佡
侄	姪
你	妳
俛	俯
冏	囧
冱	沍
姐	姊
婬	淫
艸	草
宂	冗
虎	乕
奇	竒
明	朙	眀
案	桉
稗	粺
榜	牓
刨	鉋	鑤
悖	誖
逼	偪
膘	臕
駁	駮
踩	跴
扯	撦
嗔	瞋
澄	澂
酬	詶
鋤	耡	鉏
捶	搥
棰	箠
錘	鎚
蠢	惷
粗	麤	觕
銼	剉
呆	獃
淡	澹
啖	啗	噉
堤	隄
蒂	蔕
蝶	蜨
喋	啑
碇	椗
豆	荳
遁	遯
扼	搤
厄	阨
翻	繙
帆	颿
痱	疿	廢
氛	雰
扛	摃
肛	疘
胳	肐	髂
菇	菰
管	筦
焊	銲	釬
皓	皜	暠
和	龢
呼	虖	謼
花	蘤	芲
恍	怳
混	溷
剪	翦
剿	勦
救	捄
揪	揫
狷	獧
眷	睠
撅	噘
浚	濬
瞰	矙
坎	埳
炕	匟
考	攷
坑	阬
愧	媿
捆	綑
婪	惏
螂	蜋
琅	瑯
楞	愣
藜	蔾
璃	琍
淋	痲
磷	燐
弄	衖
碌	磟
裸	臝
眯	瞇
渺	淼
妙	玅
幕	幙
拿	挐	拏
奶	嬭
乃	迺
楠	柟
霓	蜺
拈	撚
粘	黏
暖	煖
炮	砲
碰	踫	掽
毗	毘
瓶	缾
棋	碁
旗	旂
槍	鎗
勤	懃
丘	坵	邱
球	毬
榷	搉
蠕	蝡
蕊	橤
睿	叡
箬	蒻
筲	蕱
參	葠
倏	儵
溯	泝
蓑	簑
拓	搨
袒	襢
趟	蹚
掏	搯
藤	籐
剃	薙
眺	覜
筒	筩
浣	澣
望	朢
忤	啎
晰	皙
勖	勗
喧	諠
楦	楥
萱	萲
胭	臙
燕	鷰
雁	鴈
夭	殀
淆	殽
耀	燿
野	埜
移	迻
殷	慇
喑	瘖
雍	雝
猿	蝯
咱	偺	喒
糟	蹧
札	劄
榨	搾
寨	砦
棹	櫂
照	炤
浙	淛
砧	碪
帙	袟
址	阯
冢	塚
撰	譔
斫	斮	斲
鬃	騣
纂	篹
累	纍
邢	郉
釼	釰
仞	仭
兎	兔
凡	凢	凣
刄	刃
刋	刊
券	劵
剙	剏
劔	劒
吞	呑
嚔	嚏
國	囯
巠	坙
埒	埓
夐	敻
媫	婕
嬎	嬔
孶	孳
尫	尪
尶	尷
彐	彑
彛	彜	彞	彝
捏	揑
昻	昂
焭	煢
皡	皥
篡	簒
羮	羹
翶	翺
舃	舄
菑	葘
赱	走
靱	靭
骩	骫
髙	高
鬬	鬭
鶇	鶫
偼	倢
勀	勊
嘷	噑
廽	廻
暭	曍
涅	湼
濲	瀔
獋	獔
蛔	蜖	痐	蚘
讆	讏
糊	餬
佑	祐
麴	麹
曲	麴	麹
麪	麵	麺	麫
面	麪	麵	麺
漓	灕
酸	痠
雕	鵰	彫	琱
裏	裡	里
谷	穀
背	揹
胡	鬍	衚
苔	薹
蒙	矇	濛	懞
舍	舎	捨
芸	蕓
蔑	衊
表	錶
致	緻
出	齣
刮	颳
千	韆
升	昇	陞
卜	蔔
卷	巻	捲
祇	祗	衹	秖
只	祇	祗	衹	秖	隻
布	佈
席	蓆
籲	吁
合	閤
吊	弔
同	衕
向	嚮	曏
冬	鼕
哄	鬨
庵	菴
周	週	賙
家	傢
弦	絃
克	剋
逥	迴
回	囘	囬	迴	逥
困	睏
夫	伕
娘	嬢	孃
局	侷	跼
咽	嚥
彩	綵
志	誌
念	唸
乾	漧
幹	榦
干	幹	乾	漧	榦
幸	倖
喂	餵
巨	鉅
借	藉
姜	薑
噪	譟
私	俬
秋	鞦
症	癥
矩	榘
皁	皂
系	係	繫	繋
挨	捱
挽	輓
慄	栗
核	覈
杆	桿
杯	盃	桮
松	鬆
板	闆
泛	氾	汎
注	註
恤	卹
才	纔
扎	紮
扣	釦
遊	游
折	摺
抵	牴	觝
拐	枴	柺
戚	慼
搜	捜	蒐
昆	崑
愈	癒	瘉
鬥	斗	闘
梁	樑
暗	闇	晻
朱	硃
欲	慾
了	瞭
仇	讎
仿	彷	倣	髣
喫	吃
它	牠
玩	翫
璇	璿
沾	霑
旋	鏇
澱	淀
采	採	寀
闢	辟
蘋	苹
範	范
準	凖	准
幾	几
廠	厂
劃	划
制	製
佔	占
臺	台	檯	颱
後	后
巖	岩	巌	喦
嶽	岳
黨	党
誇	夸
諮	咨
屍	尸
奸	姦
徵	征	徴
御	禦
傑	杰
沈	瀋
願	愿
萬	万
醜	丑
豐	丰	豊
夥	伙
於	于
雲	云
僕	仆
傭	佣
鬱	郁
樸	朴
僵	殭
醃	腌
兇	凶
簾	帘
鹹	咸
種	种
築	筑
塗	涂
槓	杠
託	托
據	据	拠
櫃	柜
湧	涌
修	脩
凌	淩
穗	穂
蹠	跖
燻	熏
煙	烟	菸
臘	腊
蠟	蜡	蝋
廣	广	広
薦	荐
蟲	虫
蠔	蚝
羶	膻
釐	厘
復	複	复	覆
並	併	倂	幷	并
確	确
掛	挂
極	极
佛	仏	彿
個	个	箇
蠍	蝎
適	适
勝	胜
葉	叶
脣	唇
價	价	価
亙	亘
胄	冑
餘	馀	余
併	倂
醞	醖
轀	輼
嬤	嬷
熅	煴
縕	緼
緪	縆
醞	醖	酝
雋	隽
麼	麽
荊	荆
脫	脱
膃	腽
蒕	蒀
羋	芈
袞	衮
薀	蕰
蛻	蜕
蘊	藴
悽	凄	淒
涼	凉
減	减
湊	凑
凜	凛
廂	厢
廈	厦
廚	厨	㕑
廄	廏	厩	廐
廝	厮
刪	删
別	别	彆
剎	刹
巹	卺
敘	敍	叙
呂	吕
吳	吴	呉
內	内
冊	册
決	决
況	况
吶	呐
宮	宫
弒	弑
強	强	彊
兌	兑
兗	兖
茲	兹
娛	娱	娯
峯	峰
剝	剥
奧	奥
勻	匀
姍	姗
媼	媪
縕	緼	缊
禿	秃
祕	秘
盜	盗
粵	粤
稟	禀
祿	禄
稅	税
羨	羡
羣	群
睜	睁
柵	栅
涗	涚
滾	滚
沒	没
溫	温
拋	抛
歿	殁
挩	捝
悅	悦
悞	悮
榲	榅
慍	愠
敓	敚
氳	氲
漵	溆
櫥	橱
搵	揾
梲	棁
丟	丢
侶	侣
俁	俣
痹	痺
幺	么
擡	抬
棱	稜
檐	簷
污	汙	汚
泄	洩
踊	踴
着	著
睾	睪
潨	潀
擡	抬
踊	踴
檯	枱
俞	兪
值	値
偷	偸
即	卽
告	吿
唧	喞
喻	喩
塈	墍
填	塡
妍	姸
媮	婾
尚	尙
屏	屛
帡	帲
惪	悳
慎	愼
既	旣
暨	曁
概	槪
榆	楡
槙	槇
清	淸
溉	漑
真	眞
研	硏
箳	簈
胼	腁
迸	逬
郎	郞
青	靑
鷏	鷆
俱	倶
查	査
瓶	甁
訮	詽
豜	豣
熙	煕
教	敎
軿	輧
暨	曁
枡	桝
涉	渉
渴	渇
假	仮
咒	呪
焰	焔	燄
瓣	弁
痹	痺
瘦	痩
皋	皐
碎	砕
粹	粋
缺	欠
罐	缶	鑵
荔	茘
薰	薫
酢	醋
陷	陥
霸	覇
乘	乗
步	歩
戾	戻
效	効	傚
敕	勅
溌	潑
溪	渓	谿
惠	恵
拂	払
拔	抜
拜	拝
搔	掻
收	収
晚	晩
曾	曽
插	挿
揭	掲
每	毎
壤	壌
壹	壱
圈	圏
德	徳
剩	剰	賸
增	増
巢	巣
繋	繫
穰	穣
稻	稲
疎	疏
竃	竈
藏	蔵
辨	弁
豫	予
黑	黒
默	黙
醉	酔
醗	醱
髓	髄
髮	髪
鑛	鉱
寯	㝦
檇	槜
臇	䐪
崑	崐
唚	吣
貍	狸
鞀	鼗
阪	坂
垵	埯
嶴	岙
襆	幞
齇	齄
檾	苘	𦼖
蔥	葱
櫱	蘖
隉	陧
韻	韵
僱	雇
黴	霉
霢	霡
韝	鞲
跡	迹	蹟
脈	脉
髒	臓	臟	脏
腳	脚
蒞	莅
虯	虬
齶	顎	腭
靦	腼
膚	肤
骯	肮
恥	耻
卻	却
叄	叁
啓	啟	启
衝	冲	沖
莊	庄	荘
牀	床
夠	够
詠	咏
吒	咤
奼	姹
稈	秆
癡	痴
豬	猪
蝟	猬
筍	笋
鹼	碱	鹸	堿
秈	籼
餱	糇
餈	糍
眥	眦
棲	栖
淚	泪	涙
恆	恒
淥	渌
戲	戯	戏
戱	戯
揯	搄
攜	携
毀	毁	燬	譭
氈	毡
曬	晒
潛	潜
瀦	潴
櫫	橥
洶	汹
懍	懔
灑	洒
窪	洼
溼	濕	湿
黃	黄
靜	静
鼴	鼹
蝨	虱
蠶	蚕
釁	衅
淨	浄	凈	净
臥	卧
崢	峥
彥	彦
喚	唤
奐	奂
猙	狰
瘓	痪
箏	筝
貓	猫
煥	焕
掙	挣
渙	涣
戶	户	戸
換	换
爭	争
兒	児	儿
陽	阳
陰	阴
階	阶
隨	随
繭	茧
襪	袜
雙	双
號	号
嘆	歎	叹
噸	吨
聽	聴	听
響	响
墾	垦
寧	宁	甯	寜
寶	宝
關	関	关
園	园
囪	囱
壞	壊	坏
屜	屧	屉
奮	奋
憂	忧
醫	医
聲	声
冪	幂
傯	偬
聖	圣
癢	痒
燈	灯
靈	霊	灵	霝
筆	笔
糉	糭	粽
網	网
梔	栀
樣	様	样
灃	沣
懷	懐	怀
撲	扑
構	构	搆
樁	桩
擔	担
驚	惊
懼	惧
戇	戆
戰	战	戦
槨	椁
撐	撑
暱	昵
敵	敌
氣	气	気
𣈶	暅
與	与
衆	眾	众
優	优
虧	亏
麼	么
亂	乱
從	従	从
體	体
藝	兿	艺	芸
廩	廪
禮	礼
隊	队
陣	阵
際	际
釀	酿	醸
鄧	邓
郵	邮
鄰	邻
選	选
遞	递	逓
黽	黾
隱	隐	隠
隸	隶	隷
難	难
麥	麦
釋	释	釈
趙	赵
趕	赶
辭	辞
邊	边	辺
遼	辽
達	达	迖
遷	迁
還	还
這	这
進	进
遠	远
遲	迟	遅
脅	胁
膽	胆
膠	胶
蘇	苏	甦	囌
獲	穫	获
虜	虏
慮	虑
虛	虚
雖	虽
蝦	虾
聯	联	連
肅	肃	粛
餚	肴
腫	肿
節	节
補	补
襯	衬
襖	袄
蹤	踪
艱	艰
豔	艷	艶	艳
鑿	凿
廳	厅	庁
歷	厤
曆	暦
歷	歴	曆	厤	历
壓	压	圧
厭	厌
縣	县	県
芻	刍
劉	刘
協	协
單	单	単
盧	卢
滷	鹵	卤
參	参	蔘	葠
變	变	変
幣	币
帥	帅
師	师
帶	帯	带
幫	帮
嚇	吓
岡	冈
啞	唖	哑
歲	歳	嵗	岁
豈	岂
嶺	岭
慶	庆
廟	庙
嘸	呒
囈	呓
審	审
開	开
異	异
棄	弃
養	养
勸	勧	劝
辦	办
務	务
動	动
勞	劳	労
團	团	団	糰
國	国	囯
塊	块
堅	坚
壇	罈	坛
墳	坟
處	䖏	処	处
夾	夹	裌
婁	娄
層	层
屆	届
屬	属
將	将
爾	尓	尔
塵	尘
堯	尧
錄	録	录	彔
徹	彻
劇	剧
憶	忆
區	区
殼	壳	殻
對	对	対
尋	寻
鞏	巩
學	学
癤	疖
療	疗
皰	疱
痾	疴
環	环
積	积
癰	痈
竊	窃
竅	窍
竄	窜
燉	炖
點	点
獻	献
癟	瘪
滅	灭
竈	灶
災	灾
燦	灿
蓋	盖
盤	盘
糶	粜
糞	粪
糧	粮
礬	矾
犛	牦	氂
牽	牵
犧	犠	牺
琺	珐
瓊	琼
礙	碍
離	离
穭	稆
糴	籴
類	类
窮	穷
愛	爱
爺	爷
電	电
畫	画
競	竞
標	标
樹	树
澀	涩	渋	濇
殺	杀
雜	杂	雑
權	权	権
條	条
來	来
溝	沟
態	态
懇	恳
棗	枣
護	护
擬	拟	儗
擁	拥
戔	戋
戩	戬
攙	搀
畢	毕
斃	毙	獘
愨	悫	慤
懸	悬
擄	掳
無	无
舊	旧
時	时
晝	昼
顯	显	顕
晉	晋
斷	断
術	术	朮
歡	歓	欢	懽	驩
漢	汉
業	业
兩	两	両
喪	丧
臨	临
麗	丽
亞	亜	亚
畝	亩
親	亲
億	亿
義	义
喬	乔
習	习
鄉	鄕	郷	乡
僅	仅
倉	仓
釒	钅
長	长
鳥	鸟
飠	饣
門	门
馬	马
龍	龙	竜
龜	龟	亀
風	风
飛	飞
鄭	郑
韋	韦
魚	鱼
齊	齐	斉
齒	歯	齿
車	车
過	过
鳳	凤	鳯
擊	击	撃
華	华
賣	卖	売
衛	衞	卫
髮	髪
發	発	髮	髪	发
疊	叠	畳
寫	写
農	农
島	岛
應	应	応
實	实	実	寔
憲	宪
蘭	兰
興	兴
圖	圗	图	図
備	备
頭	头
奪	夺
嘗	尝	嚐
盡	儘	尽
當	当	噹
導	导
壽	夀	寿
孫	孙
總	総	总
報	报
彙	彚
匯	汇	彙	彚
專	専	专	耑
叢	丛
東	东
嚴	严	厳
爲	為	为
會	会
傘	伞	繖
產	産	产
烏	乌
樂	乐	楽
書	书
買	买
侖	崙	崘	仑
僉	佥
轀	輼	辒
蘊	藴	蕴
軿	輧	𫐌
㘔	㗷
𣍐	𠊉
檾	𦼖
鮕	𩾀
𪈼	𪉓
𪋿	𪎍
鑑	鑒	鉴
鑾	銮
鏨	錾
饜	餍
藪	薮
蠨	蟏
襴	襕
誾	訚
讋	詟
豶	豮
囂	嚣
壪	塆
牆	墙	墻
獺	獭
籪	簖
緊	紧
縶	絷
攢	攒
樓	楼
檁	檩
殲	歼
䁻	䀥
瞜	䁖
碽	䂵
磾	䃅
筴	䇲
籔	䉤
䎱	䎬
膞	䏝
𦪙	䑽
螮	䗖
貙	䝙
躎	䟢
靦	䩄
𩞯	䭪
龑	䶮
劚	㔉
㘚	㘎
㜄	㚯
幓	㡎
慺	㥪
㩜	㨫
瀇	㲿
潚	㴋
獱	㺍
𩏷	𫃗
𩯁	𫙂
䵳	𪑅
𪔵	𪔭
𠿕	𪜎
凙	𪞝
㪎	𪯋
曊	𪰶
欑	𪴙
䪗	𩐀
顂	𩓋
𩚛	𩟿
𩡣	𩡖
䯤	𩩈
鬖	𩭹
𩯳	𩯒
𩰹	𩰰
𩳤	𩲒
𩴵	𩴌
𨅍	𨁴
𨈊	𨂺
𨈌	𨄄
軉	𨉗
䢨	𨑹
𨣞	𨟳
𨣧	𨠨
𨤻	𨤰
䦳	𨷿
斸	𣃁
曥	𣆐
𣋋	𣈣
臗	𣎑
槫	𣏢
𣠲	𣑶
楇	𣒌
橯	𣓿
樤	𣔌
欘	𣚚
𣠩	𣞎
殢	𣨼
𣯴	𣭤
𣯩	𣯣
氭	𣱝
㵗	𣳆
𤅶	𣷷
濆	𣸣
瀃	𣽷
䍽	𦍠
朥	𦛨
膢	𦝼
𦣎	𦟗
𦪽	𦨩
蘟	𦻕
熡	𤋏
𤛮	𤙯
𤢟	𤝢
㺏	𤠋
瓕	𤦀
瓛	𤩽
𤳸	𤳄
㿗	𤻊
㿧	𤽯
皟	𤾀
麬	𤿲
䀉	𥁢
瞤	𥆧
䁪	𥇢
䂎	𥎝
𥞵	𥞦
𥨐	𥧂
籅	𥫣
𥵊	𥭉
𥵃	𥱔
𥼽	𥹥
𠁞	𠀾
俓	𠇹
儭	𠋆
𠠎	𠚳
勑	𠡠
嗰	𠮶
囃	𠱞
𡅏	𠲥
㢝	𢋈
㦛	𢗓
㦎	𢛯
懎	𢠁
𤢻	𢢐
戰	𢧐	戦
擣	𢭏
斅	𢽾
𧎈	𧌥
蠾	𧑏
𧔥	𧒭
䙱	𧜭
詀	𧮪
𧳟	𧳕
𨇁	𧿈
𡔖	𡍣
壈	𡒄
㜷	𡝠
孎	𡠟
孻	𡥧
嵼	𡶴
𡽗	𡸃
鈾	铀
鐵	鉄	铁
鉑	铂
鈴	铃
鑠	铄
鉛	铅
鉚	铆
鉋	铇
鈰	铈
鉉	铉
鉈	铊
鉍	铋
鈮	铌
鈹	铍
鐸	铎
鉶	铏
銬	铐
銠	铑
鉺	铒
鋩	铓
錏	铔
銪	铕
鋮	铖
鋏	铗
鋣	铘
鐃	铙
銍	铚
鐺	铛
銅	铜
鋁	铝
銱	铞
銦	铟
鎧	铠
鍘	铡
銖	铢
銑	铣
鋌	铤
銩	铥
銛	铦
鏵	铧
銓	铨
鎩	铩
鉿	铪
銚	铫
鉻	铬
銘	铭
錚	铮
銫	铯
鉸	铰
銥	铱
鏟	铲	剷
銃	铳
鐋	铴
銨	铵
銀	银
銣	铷
鑄	鋳	铸
鐒	铹
鋪	舗	舖	铺
鋙	铻
錸	铼
鋱	铽
鏈	錬	鍊	链
鏗	铿
銷	销
鎖	锁
鋰	锂
鋥	锃
鋤	锄
鍋	锅
鋯	锆
鋨	锇
鏽	銹	锈
銼	锉
鋝	锊
鋒	锋
鋅	锌
鋶	锍
鐦	锎
鐧	鐗	锏
銳	鋭	锐
銻	锑
鋃	锒
鋟	锓
鋦	锔
錒	锕
錆	锖
鍺	锗
鍩	锘
錯	错
錨	锚
錛	锛
錡	锜
鍀	锝
錁	锞
錕	锟
錩	锠
錫	锡
錮	锢
鑼	锣
錘	锤
錐	锥
錦	锦
鑕	锧
鍁	锨	杴
錈	锩
鍃	锪
錇	锫	鉳
錟	锬
錠	锭
鍵	键
鋸	锯
錳	锰
錙	锱
鍥	锲
鍈	锳
鍇	锴
鏘	锵
鍶	锶
鍔	锷
鍤	锸
鍬	锹
鍾	锺
鍛	锻
鎪	锼
鍠	锽
鍰	锾
鎄	锿
魨	鲀
魯	鲁
魴	鲂
䰾	鲃
魺	鲄
鮁	鲅
鮃	鲆
鮎	鯰	鲇
鱸	鲈
鮋	鲉
鮓	鲊
鮒	鲋
鮊	鲌
鮑	鲍
鱟	鲎
鮍	鲏
鮐	鲐
鮭	鲑
鮚	鲒
鮳	鲓
鮪	鲔
鮞	鲕
鮦	鲖
鰂	鲗
鮜	鲘
鱠	鲙
鱭	鲚
鮫	鲛
鮮	鲜	尟
鮺	鲝
鯗	鲞
鱘	鲟
鯁	鲠	骾
鱺	鲡
鰱	鲢
鰹	鲣
鯉	鲤
鰣	鲥
鰷	鲦
鯀	鲧
鯊	鲨
鯇	鲩
鮶	鲪
鯽	鲫
鯒	鲬
鯖	鲭
鯪	鲮
鯕	鲯
鯫	鲰
鯡	鲱
鯤	鲲
鯧	鲳
鯝	鲴
鯢	鲵
鯰	鲶
鯛	鲷
鯨	鲸
鰺	鲹
鯴	鲺
鯔	鲻
鱝	鲼
鰈	鲽
鰏	鲾
鱨	鲿
釓	钆
釔	钇
針	鍼	针
釘	钉
釗	钊
釙	钋
釕	钌
釷	钍
釺	钎
釧	钏
釤	钐
鈒	钑
釩	钒
釣	钓
鍆	钔
釹	钕
鍚	钖
釵	钗
鈃	銒	钘
鈣	钙
鈈	钚
鈦	钛
鉅	钜
鈍	钝
鈔	钞
鍾	钟	鐘	鈡
鈉	钠
鋇	钡
鋼	钢
鈑	钣
鈐	钤
鑰	钥	鈅
欽	钦
鈞	钧
鎢	钨
鉤	鈎	钩
鈧	钪
鈁	钫	鍅
鈥	钬
鈄	钭
鈕	钮
鈀	钯
鈺	钰
錢	銭	钱
鉦	钲
鉗	钳
鈷	钴
鉢	缽	钵
鈳	钶
鉕	钷
鈽	钸
鈸	钹
鉞	钺
鑽	鉆	钻
鉬	钼
鉭	钽
鉀	钾
鈿	钿
鍍	镀
鎂	镁
鏤	镂
鎡	镃
鐨	镄
鎇	镅
鏌	镆
鎮	鎭	镇
鎛	镈
鎘	镉
鑷	镊
钂	鎲	镋
鐫	鎸	镌
鎳	镍
鎿	镎	錼
鎦	镏
鎬	镐
鎊	镑
鎰	镒
鎵	镓
鑌	镔
鎔	镕	熔
鏢	镖
鏜	镗
鏝	镘
鏍	镙
鏰	镚
鏞	镛
鏡	镜
鏑	镝
鏃	镞
鏇	镟
鏐	镠
鐔	镡
钁	鐝	镢
鐐	镣
鏷	镤
鑥	镥
鐓	镦
鑭	镧
鐠	镨
鑹	镩
鏹	镪
鐙	镫
鑊	镬
鐳	镭
鐶	镮
鐲	镯
鐮	鎌	镰
鐿	镱
鑔	镲
鑣	镳
鑞	镴
鑱	镵
鑲	镶
鵐	鹀
鵓	鹁
鸝	鹂
鵑	鹃
鵠	鹄
鵝	鹅
鵒	鹆
鷳	鷴	鹇
鵜	鹈
鵡	鹉
鵲	鹊
鶓	鹋
鵪	鹌
鵾	鹍
鵯	鹎
鵬	鹏
鵮	鹐
鶉	鹑
鶊	鹒
鵷	鹓
鷫	鹔
鶘	鹕
鶡	鹖
鶚	鹗
鶻	鹘
鶖	鹙
鷀	鶿	鹚
鶥	鹛
鶩	鹜
鷊	鹝
鷂	鹞
鶲	鹟
鶹	鹠
鶺	鹡
鷁	鹢
鶼	鹣
鶴	鹤
鷖	鹥
鸚	鹦
鷓	鹧
鷚	鹨
鷯	鹩
鷦	鹪
鷲	鹫
鷸	鹬
鷺	鹭
䴉	鹮
鸇	鹯
鷹	鹰
鸌	鹱
鸏	鹲
鸛	鹳
鸘	鹴
鹺	鹾
頎	颀
頒	颁
頌	颂
頏	颃
預	预
顱	颅
領	领
頗	颇
頸	颈
頡	颉
頰	颊
頲	颋
頜	颌
潁	颍
熲	颎
頦	颏
頤	颐
頻	频
頮	颒
頹	頽	颓	穨
頷	颔
頴	颕
穎	頴	颖
顆	颗
題	题
顒	颙
顎	颚
顓	颛
顏	顔	颜
額	额
顳	颞
顢	颟
顛	顚	颠
顙	颡
顥	颢
纇	颣
顫	颤
顬	颥
顰	颦
顴	颧
駘	骀
驍	骁
罵	駡	骂
駰	骃
驕	骄
驊	骅
駱	骆
駭	骇
駢	騈	骈
驫	骉
驪	骊
騁	骋
驗	验	験
騂	骍
駸	骎
駿	骏
騏	骐
騎	骑
騍	骒
騅	骓
騌	骔
驌	骕
驂	骖
騙	骗
騭	骘
騤	骙
騷	騒	骚
騖	骛
驁	骜
騮	骝
騫	骞
騸	骟
驃	骠
騾	骡
驄	骢
驏	骣
驟	骤
驥	骥
驦	骦
驤	骧
鯷	鳀
鰮	鰛	鳁
鰃	鳂
鰓	鳃
鱷	鰐	鳄
鰍	鳅
鰒	鳆
鰉	鳇
鰁	鳈
鱂	鳉
鯿	鳊
鰠	鳋
鰲	鼇	鳌
鰭	鳍
鰨	鳎
鰥	鳏
鰩	鳐
鰟	鳑
鰜	鳒
鰳	鳓
鰾	鳔
鱈	鳕
鱉	鼈	鳖
鰻	鳗
鰵	鳘
鱅	鳙
䲁	鳚
鰼	鳛
鱖	鳜
鱔	鳝
鱗	鳞
鱒	鳟
鱯	鳠
鱤	鳡
鱧	鳢
鱣	鳣
䲘	鳤
閥	阀
閣	阁
閡	阂
閫	阃
鬮	阄
閱	閲	阅
閬	阆
闍	阇
閾	阈
閹	阉
閶	阊
鬩	阋
閿	阌
閽	阍
閻	阎
閼	阏
闡	阐
闌	阑
闃	阒
闠	阓
闊	阔
闋	阕
闔	阖
闐	阗
闒	阘
闕	阙
闞	阚
闤	阛
鳩	鸠
雞	鶏	鷄	鸡
鳶	鸢
鳴	鸣
鳲	鸤
鷗	鴎	鸥
鴉	鸦
鶬	鸧
鴇	鸨
鴆	鸩
鴣	鸪
鶇	鸫
鸕	鸬
鴨	鸭
鴞	鸮
鴦	鸯
鴒	鸰
鴟	鸱
鴝	鸲
鴛	鸳
鷽	鸴
鴕	鸵
鷥	鸶
鷙	鸷
鴯	鸸
鴰	鸹
鵂	鸺
鴴	鸻
鵃	鸼
鴿	鸽
鸞	鵉	鸾
鴻	鸿
飣	饤
飢	饑	饥
飥	饦
餳	饧
飩	饨
餼	饩
飪	饪
飫	饫
飭	饬
飯	饭
飲	飮	饮
餞	饯
飾	饰
飽	饱
飼	饲
飿	饳
飴	饴
餌	饵
饒	饶
餉	饷
餄	饸
餎	饹
餃	饺
餏	饻
餅	餠	饼
餑	饽
餖	饾
餓	饿
閂	闩
閃	闪
閆	闫
閈	闬
閉	闭
問	问
闖	闯
閏	闰
闈	闱
閒	閑	闲
閎	闳
間	间
閔	闵
閌	闶
悶	闷
閘	闸
鬧	閙	闹
閨	闺
聞	闻
闥	闼
閩	闽
閭	闾
闓	闿
餒	馁
餕	馂
餜	馃
餛	馄
餡	馅
館	馆
餷	馇
饋	馈	餽
餶	馉
餿	馊
饞	馋
饁	馌
饃	馍
餺	馎
餾	馏
饈	馐
饉	馑
饅	馒
饊	馓
饌	馔
饢	馕
馭	驭
馱	駄	驮
馴	驯
馳	驰
驅	駆	驱
馹	驲
駁	驳
驢	驴
駔	驵
駛	驶
駟	驷
駙	驸
駒	驹
騶	驺
駐	驻
駝	驼
駑	驽
駕	驾
驛	驿	駅
齔	龀
齕	龁
齗	龂
齟	龃
齡	齢	龄
齙	龅
齠	龆
齜	龇
齦	龈
齬	龉
齪	龊
齲	龋
齷	龌
龔	龚
龕	龛
颺	飏
颭	飐
颮	飑
颯	飒
颶	飓
颸	飔
颼	飕
颻	飖
飀	飗
飄	飘
飆	飙
飈	飚
饗	飨
頁	页
頂	顶
頃	顷
頇	顸
項	项
順	顺
須	须	鬚
頊	顼
頑	顽
顧	顾
頓	顿
陸	陆
隴	陇
陳	陈
陘	陉
陝	陕
隯	陦
隕	陨
險	险	険
郟	郏
鄶	郐
鄆	郓
酈	郦
鄖	郧
鄲	郸
酇	酂
醱	酦
醬	醤	酱
釅	酽
釃	酾
韌	韧
韍	韨
韓	韩
韙	韪
韞	韫
韜	韬
鄺	邝
鄔	邬
鄒	邹
鄴	邺
遜	逊
邐	逦
邏	逻
雛	雏
讎	雠
靂	雳
霧	雾
黌	黉
黶	黡
黷	黩
黲	黪
靚	靓
靝	靔
靨	靥
麩	麸
霽	霁
靄	霭
韃	鞑
鞽	鞒
韉	鞯
魛	鱽
魢	鱾
魷	鱿
黿	鼋
鼂	鼌
鼉	鼍
䃮	鿎
䥑	鿏
鿓	鿒
鎶	鿔
髏	髅
髖	髋
髕	髌
齏	齑
遺	遗
遙	遥
鬢	鬓
鬹	鬶
魘	魇
魎	魉
訣	诀
證	証	证
詁	诂
訶	诃
評	评
詛	诅
識	识
詗	诇
詐	诈
訴	诉	愬
診	诊
詆	诋
謅	诌
詞	词
詘	诎
詔	诏
詖	诐
譯	译	訳
詒	诒
誆	诓
誄	诔
試	试
詿	诖
詩	诗
詰	诘
詼	诙
誠	诚
誅	诛
詵	诜
話	话	諙
誕	诞
詬	诟
詮	诠
詭	诡
詢	询
詣	诣
諍	诤
該	该
詳	详
詫	诧
諢	诨
詡	诩
譸	诪
誡	诫
誣	诬
語	语
誚	诮
誤	误
誥	诰
誘	诱
誨	诲
誑	诳
說	説	说
誦	诵
誒	诶
請	请
諸	诸
諏	诹
諾	诺
讀	读	読
諑	诼
誹	诽
課	课
諉	诿
諛	谀
誰	谁
諗	谂
調	调
諂	谄
諒	谅
諄	谆
誶	谇
談	谈
讅	谉
誼	谊
謀	谋
諶	谌
諜	谍
謊	谎
諫	諌	谏
諧	谐
謔	谑
謁	谒
謂	谓
諤	谔
諭	谕
諼	谖
讒	谗
諮	谘
諳	谙
諺	谚
諦	谛
謎	谜
諞	谝
諝	谞
謨	谟
讜	谠
謖	谡
謝	谢
謠	謡	谣
謗	谤
諡	謚	谥
謙	谦
謐	谧
謹	谨
謾	谩
謫	谪
譾	谫
謬	谬
譚	谭
譖	谮
譙	谯
讕	谰
譜	谱
譎	谲
讞	谳
譴	谴
譫	谵
讖	谶
貲	赀
賃	赁
賂	赂
贓	赃
資	资
賅	赅
贐	赆
賕	赇
賑	赈
賚	赉
賒	赊
賦	赋
賭	赌
齎	賫	赍
贖	赎
賞	赏
賜	赐
贔	赑
賙	赒
賡	赓
賠	赔
賧	赕
賴	頼	赖
賵	赗
贅	赘
賻	赙
賺	赚
賽	赛
賾	赜
贗	贋	赝
贊	賛	讚	赞
贇	赟
贈	赠
贍	赡
贏	赢
贛	赣	灨
赬	赪
貝	贝
貞	贞
負	负
貟	贠
貢	贡
財	财
責	责
賢	贤
敗	败
賬	账
貨	货
質	质
販	贩
貪	贪
貧	贫
貶	贬
購	购
貯	贮
貫	贯
貳	贰	弐
賤	贱
賁	贲
貰	贳
貼	贴
貴	贵
貺	贶
貸	贷
貿	贸
費	费
賀	贺
貽	贻
賊	贼
贄	贽
賈	贾
賄	贿
輈	辀
輇	辁
輅	辂
較	较
輒	辄
輔	辅
輛	輌	辆
輦	辇
輩	辈
輝	辉
輥	辊
輞	辋
輬	辌
輟	辍
輜	輺	辎
輳	辏
輻	辐
輯	辑
輸	输
轡	辔
轅	辕
轄	辖
輾	辗
轆	辘
轍	辙
轔	辚
辯	辩	弁
辮	辫
訁	讠
計	计
訂	订
訃	讣
認	认
譏	讥
訐	讦
訌	讧
討	讨
讓	譲	让
訕	讪
訖	讫
託	讬
訓	训
議	议
訊	讯
記	记
訒	讱
講	讲
諱	讳
謳	讴
詎	讵
訝	讶
訥	讷
許	许
訛	讹
論	论
訩	讻
訟	讼
諷	讽
設	设
訪	访
軋	轧
軌	轨
軒	轩
軑	轪
軔	轫
轉	转	転
軛	轭
輪	轮
軟	软
轟	轰
軲	轱
軻	轲
轤	轳
軸	轴
軹	轵
軼	轶
軤	轷
軫	轸
轢	轹
軺	轺
輕	軽	轻
軾	轼
載	载
輊	轾
轎	轿
薘	荙
莢	荚
蕘	荛
蓽	荜
萴	荝
蕎	荞	荍
薈	荟
薺	荠
蕩	盪	荡
榮	荣	栄
葷	荤
滎	荥
犖	荦
熒	荧
蕁	荨
藎	荩
蓀	荪
蔭	廕	荫
蕒	荬
葒	荭
葤	荮
藥	薬	葯	药
見	见
觀	観	观
覎	觃
規	规
覓	觅
視	视
覘	觇
覽	覧	览
覺	覚	觉
覬	觊
覡	觋
覿	觌
覥	觍
覦	觎
覯	觏
覲	觐
覷	觑
觴	觞
觸	触
觶	觯
邁	迈
運	运
違	违
連	连
邇	迩
逕	迳
脹	胀
朧	胧
腖	胨
臚	胪
脛	胫
膾	脍
臍	脐
腦	脑	脳
膿	脓
臠	脔
腡	脶
臉	脸
蓯	苁
葦	苇
藶	苈
莧	苋
萇	苌
蒼	苍
苧	苎
薴	苧
萊	莱
蓮	莲
蒔	莳
萵	莴
薟	莶
蕕	莸
瑩	莹
鶯	莺
蓴	蒓	莼
蟣	虮
蠆	虿
躍	跃
蹌	跄
躒	跞
踐	践
躂	跶
蹺	跷
蹕	跸
躚	跹
躋	跻
蠱	蛊
蠣	蛎
蟶	蛏
蠻	蛮
蟄	蛰
蛺	蛱
蟯	蛲
螄	蛳
蠐	蛴
膕	腘
膩	腻
騰	腾
聶	聂
聾	聋
職	职
聹	聍
聵	聩
聰	聡	聪
腸	肠
腎	肾
莖	茎
蘢	茏
蔦	茑
塋	茔
煢	茕
蘀	萚
蘿	萝
螢	萤	蛍
營	营	営
縈	萦
蕭	萧
薩	萨
蕆	蒇
蕢	蒉
蔣	蒋
蔞	蒌
醟	蒏
蝕	蚀
蟻	蚁
螞	蚂
蠁	蚃
蜆	蚬
裝	装
襠	裆
褌	裈
褳	裢
襝	裣
褲	裤
襉	襇	裥
輿	舆
艤	舣
艦	舰
艙	舱
艫	舻
薌	芗
蕪	芜
蘆	芦
藍	蓝
薊	蓟
蘺	蓠
蕷	蓣
鎣	蓥
驀	蓦
虆	蔂
薔	蔷
蘞	蔹
藺	蔺
藹	蔼
蠅	蝇
蟈	蝈
蟬	蝉
螻	蝼
蠑	蝾
銜	衔	啣
嫋	裊	袅	嬝	褭
褘	袆
襲	袭
襏	袯
耮	耢
耬	耧
聳	耸
躊	踌
躓	踬
躑	踯
躡	蹑
蹣	蹒
躕	蹰
躥	蹿
蘄	蕲
蝸	蜗
趨	趋
趲	趱
躉	趸
躪	躏
躦	躜
軀	躯
臏	膑
臢	臜
蘚	藓
螿	螀
蟎	螨
褸	褛
襤	褴
譽	誉
謄	誊
鳧	鳬	凫
憑	凭
凱	凯
厲	厉
厙	厍
龎	厐
廁	厠	厕
厴	厣
則	则
剛	刚
創	创
剗	刬
剄	刭
劊	刽
㓨	刾
劌	刿
靉	叆
靆	叇
嘰	叽
幃	帏
帳	帐
幟	帜
幀	帧
幬	帱
幘	帻
幗	帼
嗎	吗
囅	冁
軍	军
馮	冯
凍	冻
噠	哒
嘵	哓
嗶	哔
噦	哕
譁	嘩	哗
噲	哙
嚌	哜
噥	哝
喲	哟
壟	垄
壠	垅
壚	垆
壘	塁	垒
堊	垩
墊	垫
埡	垭
墶	垯
壋	垱
塏	垲
堖	垴
嶇	岖
崗	岗
峴	岘
嵐	岚
崬	岽
巋	岿
廬	庐
廡	庑
庫	库
龐	庞
廢	废	廃
廎	庼
嘔	呕
嚦	呖
唄	呗
員	员
咼	呙
嗆	呛
嗚	呜
寵	宠
寬	寛	宽
賓	宾
張	张
彌	瀰	弥
弳	弪
彎	弯
彈	弹	弾
獸	兽	獣
勱	劢
勵	励
勁	劲
勢	势
圍	围	囲
圇	囵
壢	坜
壩	坝
塢	坞
墜	坠
婭	娅
嬈	娆
嬌	娇
孌	娈
媧	娲
嫺	嫻	娴
屓	屃
屢	屡
屨	屦
嶼	屿
嚨	咙
嚀	咛
噝	咝
嘖	啧
嗇	啬
囀	啭
齧	𫜩
齧	啮	噛	嚙	囓
嘓	啯
囉	啰
嘽	啴
嘯	啸
尷	尴
嶨	峃
嶧	峄
峽	峡
嶢	峣
嶠	峤
巒	峦
歸	帰	归
彠	彟
彲	彨
嘜	唛
嗊	唝
嘮	唠
啢	唡
嗩	唢
剴	剀
劑	剂	剤
剮	剐
劍	剑	剣	劎	劔	剱
奩	奁
獎	奨	奬	奖
妝	粧	妆
婦	妇
媽	妈
嫵	妩
嫗	妪
嬀	媯	妫
懺	忏
愾	忾
儎	傤
儻	傥
儐	傧
儲	储
儺	傩
匭	匦
匱	匮
壯	壮
壺	壶
壼	壸
寢	寝
僂	偻
僨	偾
償	偿
噴	喷
嘍	喽
嚳	喾
圓	圎	圆	円
壙	圹
場	场
嫿	婳
嬰	婴
嬋	婵
嬸	婶
嶗	崂
崍	崃
嶮	崄
嶄	崭
巔	巓	巅
巰	巯
徑	径
徠	徕
債	债
傾	倾
噓	嘘
嚶	嘤
囑	嘱
塒	埘
壎	塤	埙
堝	埚
嬡	嫒
嬪	嫔
嬙	嫱
孿	孪
嶸	嵘
嶔	嵚
嶁	嵝
勳	勛	勲	勋
勩	勚
囁	嗫
噯	嗳
嚕	噜
塹	堑
墮	堕
嬃	媭
紺	绀
紲	绁	絏
紱	绂
練	练
組	组
紳	绅
細	细
織	织
終	终
縐	绉
絆	绊
紼	绋
絀	绌
紹	绍
繹	绎
經	経	经
紿	绐
綁	绑
絨	绒	羢	毧
結	结
絝	绔
繞	绕	遶
絰	绖
絎	绗
繪	絵	绘
給	给
絢	绚
絳	绛
絡	络
絕	絶	绝
絞	绞
統	统
綆	绠
綃	绡
絹	绢
繡	繍	綉	绣
綌	绤
綏	绥
絛	绦	縚
繼	継	继
綈	绨
績	绩
緒	緖	绪
綾	绫
緓	绬
續	续	続
綺	绮
緋	绯
綽	绰
鞝	緔	绱
緄	绲
繩	縄	绳
維	维
綿	绵
綬	绶
繃	綳	绷
綢	绸
綯	绹
綹	绺
綣	绻
綜	综
綻	绽
綰	绾
綠	緑	绿
綴	缀
緇	缁
緙	缂
緗	缃
緘	缄	椷
緬	缅
纜	缆
緹	缇
緲	缈
緝	缉
繢	缋
緦	缌
綞	缍
緞	缎
緶	缏
線	綫	缐
緱	缑
縋	缒
緩	缓
締	缔
縷	缕
編	编
緡	缗
緣	縁	缘
縉	缙
縛	缚
縟	缛
縝	缜
縫	缝
縗	缞
縞	缟
纏	缠
縭	缡
縊	缢
縑	缣
繽	缤
縹	缥
縵	缦
縲	缧
纓	缨
縮	缩
繆	缪
繅	缫
纈	缬
繚	缭
繕	缮
繒	缯
繮	韁	缰
繾	缱
繰	缲
繯	缳
繳	缴
纘	缵
糹	纟
糾	纠
紆	纡
紅	红
紂	纣
纖	繊	縴	纤
紇	纥
約	约
級	级
紈	纨
纊	纩
紀	纪
紉	纫
緯	纬
紜	纭
紘	纮
純	纯
紕	纰
紗	纱
綱	纲
納	纳
紝	纴
縱	縦	纵
綸	纶
紛	纷
紙	纸
紋	纹
紡	纺
紵	纻
紖	纼
紐	纽
紓	纾
線	线
爍	烁
爛	烂
烴	烃
燭	烛
煩	烦
燒	焼	烧
燁	烨
燴	烩
燙	烫
燼	烬
熱	热
瘧	疟
癘	疠
瘍	疡
癧	疬
瘲	疭
瘡	疮
瘋	疯
狽	狈
獮	狝
獰	狞
獨	独
狹	狭
獅	狮
獪	狯
獄	狱
猻	狲
璣	玑
璵	玙
瑒	玚
瑪	玛
瑋	玮
現	现
瑲	玱
璽	玺
礎	础
硜	硁
碩	硕
硤	硖
磽	硗
磑	硙
礄	硚
磠	硵
礆	硷
稱	称
穢	秽
穠	秾
痙	痉
瘂	痖
癆	痨
癇	痫
碭	砀
碼	码
磚	砖	塼
硨	砗
硯	砚
碸	砜
礪	砺
礱	砻
礫	砾
窵	窎
窯	窑
窩	窝
窺	窥	闚
竇	窦
窶	窭
篳	筚
篩	筛
簹	筜
籌	筹
篔	筼
籤	簽	签
篠	筿
煬	炀
爐	炉
煒	炜
熗	炝
煉	錬	鍊	炼
熾	炽
獫	猃
獵	猎	猟
獼	猕
玀	猡
癉	瘅
瘮	瘆
瘞	瘗
瘻	瘘
癱	瘫
癮	瘾
癭	瘿
簡	简
籙	箓
簀	箦
篋	箧
籜	箨
籮	箩
簞	箪
簫	箫
灝	灏
篤	笃
筧	笕
箋	笺	牋
籠	笼
籩	笾
盞	盏	琖	醆
鹽	盐	塩
監	监
禡	祃
禕	祎
禰	祢
禎	祯
禱	祷
禍	祸
糲	粝
罌	罂	甖
羅	罗
罰	罸	罚
罷	罢
羆	罴
犢	犊
狀	状
獷	犷
獁	犸
猶	犹
矯	矫
磯	矶
礦	矿
簣	篑
簍	篓
籃	篮
籛	篯
籬	篱
牘	牍
瓏	珑
璫	珰
琿	珲
璡	琎
璉	琏
瑣	琐
皚	皑
皺	皱
皸	皲
磧	碛
磣	碜
禪	禅
穌	稣
穩	穏	稳
籟	籁
糝	糁
羈	羁
羥	羟
燜	焖
燾	焘
瑤	瑶
璦	瑷
璸	瑸
瓚	瓒
甕	瓮	罋
甌	瓯
癩	癞
癬	癣
癲	癫
瞘	眍
矓	眬
睞	睐
瞼	睑
瞶	瞆
瞞	瞒
矚	瞩
穡	穑
穭	穞
翹	翘
翽	翙
翬	翚
瓔	璎
暢	畅
疇	畴
豎	竪	竖
浹	浃
淺	浅
漿	浆
澆	浇
湞	浈
溮	浉
濁	浊
測	测
澮	浍
濟	济	済
瀏	浏
滻	浐
渾	浑
滸	浒
濃	浓
潯	浔
濜	浕
摯	挚
攣	挛
掗	挜
撾	挝
撻	挞
挾	挟
撓	挠
擋	攩	挡
撟	挢
擠	挤
揮	挥
撏	挦
棧	桟	栈
櫛	栉
櫳	栊
棟	栋
櫨	栌
櫟	栎
欄	栏
欒	栾
濤	涛
澇	涝
淶	涞
漣	涟
潿	涠
渦	涡
溳	涢
滌	涤
潤	润
澗	涧
漲	涨
楊	杨
榪	杩
潷	滗
滯	滞
灩	灧	滟
灄	滠
滿	满	満
瀅	滢
滬	沪
濾	滤	沪
濫	滥
灤	滦
濱	滨	浜
灘	滩
澦	滪
漚	沤
瀝	沥
淪	沦
滄	沧
渢	沨
潙	溈	沩
濘	泞
澩	泶
瀧	泷	滝
瀘	泸
濼	泺
瀉	泻
潑	泼
澤	泽	沢
涇	泾
慫	怂
憮	怃
慪	怄
悵	怅
愴	怆
憐	怜
懟	怼
懌	怿
戀	恋
惡	悪	恶	噁
慟	恸
懨	恹
愷	恺
惻	恻
惱	恼	悩
惲	恽
執	执
擴	扩	拡
捫	扪
掃	扫
揚	扬
擾	扰
樅	枞
樞	枢
櫪	枥
梘	枧
棖	枨
槍	枪	鎗
楓	枫
梟	枭
椏	桠
橈	桡
楨	桢
檔	档
榿	桤
橋	桥
樺	桦
檜	桧
槳	桨
樳	桪
淵	渊
漬	渍
瀆	渎
漸	渐
澠	渑
漁	渔
瀋	渖
滲	渗
撫	抚
摶	抟
摳	抠
掄	抡
搶	抢
攏	拢
揀	拣
攔	拦
擰	拧
撥	拨
擇	择	択
慘	惨
懲	惩
憊	惫
愜	惬
慚	惭
憚	惮
慣	惯
戧	戗
槼	椝
櫝	椟
槧	椠
槶	椢
欏	椤
樿	椫
橢	椭
槮	椮
殤	殇
殘	残
殞	殒
殮	殓
殫	殚
殯	殡
毆	殴
撈	捞
損	损
撿	捡
搗	捣
擱	搁
摟	搂
攪	撹	搅
轂	毂
毿	毵
𣯶	毶
慳	悭
憫	悯
摑	掴
擲	掷
撣	掸
摻	掺
摜	掼
攝	摄	摂
攄	摅
擺	襬	摆
搖	揺	摇
擯	摈
攤	擹	摊
攖	撄
攆	撵
擷	撷
擼	撸
攛	撺
曠	旷
暘	旸
曇	昙
曨	昽
曉	暁	晓
曄	晔
暈	晕
暉	晖
欖	榄
櫬	榇
櫚	榈
櫸	榉
樧	榝
瀠	潆
瀟	潇
瀲	潋
濰	潍
憤	愤
憒	愦
斂	敛	歛
斆	敩
數	数
齋	斋	斎
斕	斓
斬	斩
夢	梦
檮	梼
棶	梾
槤	梿
氌	氇
氫	氢
氬	氩
濚	溁
潰	溃
濺	溅
漊	溇
暫	暂
曖	暧
機	机
檟	槚
檻	槛
檳	槟
櫧	槠
櫓	橹
櫞	橼
歟	欤
歐	欧
湯	汤
懣	懑
懶	懒	嬾
攬	揽
撳	揿
檸	柠
檉	柽
檢	检	検
欞	櫺	棂
橫	横
檣	樯
櫻	樱	桜
潔	洁
懾	慑
憖	慭
㩵	擜
擻	擞
灣	湾
瀂	澛
瀾	澜
瀨	瀬	濑
瀕	濒
絲	糸	丝
舉	挙	举
傴	伛
偉	伟
傳	传	伝
俥	伡
俔	伣
傷	伤
倀	伥
倫	伦
傖	伧
僞	偽	伪
佇	伫
褻	亵
嚲	亸
䊷	䌶
紬	䌷
縳	䌸
絅	䌹
䋙	䌺
䋚	䌻
綐	䌼
綵	䌽
䋻	䌾
䋹	䌿
儀	仪
們	们
俠	侠
僥	侥	儌
偵	侦	遉
側	侧
僑	侨
儈	侩
儕	侪
儂	侬
儘	侭
俊	儁
儔	俦
儼	俨
倆	俩
儷	俪
倈	俫
儉	俭	倹
𨦫	䦀
𨧜	䦁
䥇	䦂
鐯	䦃
鐥	䦅
钁	䦆
䦛	䦶
䦟	䦷
䱽	䲝
𩶘	䲞
鮣	䲟
鰆	䲠
鰌	䲡
鰧	䲢
䱷	䲣
鳾	䴓
鵁	䴔
鴷	䴕
鶄	䴖
鶪	䴗
鷉	鷈	䴘
鸊	䴙
訢	䜣	欣
鿁	䜤
𧩙	䜥
䜀	䜧
讌	䜩	宴
薵	䓓
薳	䓕
藭	䓖
罃	䓨
𧵳	䞌
䝼	䞍
𧶧	䞎
賰	䞐
釾	䥺
鏺	䥽
䥱	䥾
𨯅	䥿
稏	䅉
穇	䅟
𥢢	䅪
繿	䍀
繸	䍁
䍦	䍠
𧜵	䙊
䙡	䙌
襬	䙓
𨊰	䢀
𨊸	䢁
𨋢	䢂
𩣑	䯃
騧	䯄
䯀	䯅
𧝞	䘛
𧜗	䘞
媰	㛀
𡞵	㛟
𡢃	㛠
㜏	㛣
孋	㛤
𡠹	㛿
濧	㳔
灡	㳕
澾	㳠
濄	㳡
𣾷	㳢
瀰	㳽
掆	㧏
㩳	㧐
撝	㧑
擓	㧟
擽	㧰
棡	㭎
椲	㭏
𣙎	㭣
樢	㭤
樫	㭴
㑳	㑇
倲	㑈
㑯	㑔
儸	㑩
傌	㐷
㑶	㐹
偑	㐽
𠗣	㓆
劏	㓥
劃	㓰
㠏	㟆
𡾱	㟜
嵾	㟥
鸂	㶉
燶	㶶
煱	㶽
璯	㻅
𤫩	㻏
𤪺	㻘
噚	㖊
喎	㖞
㥮	㤘
懤	㤽
殰	㱩
殨	㱮
𧭹	𫍐
訑	𫍙
訞	𫍚
訜	𫍛
詓	𫍜
諫	𫍝
𧦝	𫍞
𧦧	𫍟
䛄	𫍠
詑	𫍡
譊	𫍢
詷	𫍣
譑	𫍤
誂	𫍥
譨	𫍦
誺	𫍧
誫	𫍨
諣	𫍩
誋	𫍪
䛳	𫍫
誷	𫍬
𧩕	𫍭
誳	𫍮
諴	𫍯
諰	𫍰
諯	𫍱
謏	𫍲
諥	𫍳
謱	𫍴
謸	𫍵
𧩼	𫍶
謉	𫍷
謆	𫍸
謯	𫍹
𧫝	𫍺
譆	𫍻	嘻
𧬤	𫍼
譞	𫍽
𧭈	𫍾
譾	𫍿
鱮	𫚈
魟	𫚉
鰑	𫚊
鱄	𫚋
魦	𫚌
魵	𫚍
𩶁	𫚎
䱁	𫚏
䱀	𫚐
鮅	𫚑
鮄	𫚒
鮤	𫚓
鮰	𫚔
鰤	𫚕
鮆	𫚖
鮯	𫚗
𩻮	𫚘
鯆	𫚙
鮿	𫚚
鮵	𫚛
䲅	𫚜
𩸄	𫚝
鯬	𫚞
𩸡	𫚟
䱧	𫚠
鯞	𫚡
鰋	𫚢
鯾	𫚣
鰦	𫚤
鰕	𫚥
鰫	𫚦
鰽	𫚧
𩻗	𫚨
𩻬	𫚩
鱊	𫚪
鱢	𫚫
𩼶	𫚬
鱲	𫚭
鳽	𫛚
鳷	𫛛
鴀	𫛜
鴅	𫛝
鴃	𫛞
鸗	𫛟
𩿤	𫛠
鴔	𫛡
鸋	𫛢
鴥	𫛣
鴐	𫛤
鵊	𫛥
鴮	𫛦
𪀖	𫛧
鵧	𫛨
鴳	𫛩
鴽	𫛪
鶰	𫛫
䳜	𫛬
鵟	𫛭
䳤	𫛮
鶭	𫛯
䳢	𫛰
鵫	𫛱
鵰	𫛲
鵩	𫛳
鷤	𫛴
鶌	𫛵
鶒	𫛶
鶦	𫛷
鶗	𫛸
𪃧	𫛹
䳧	𫛺
𪃒	𫛻
䳫	𫛼
鷅	𫛽
𪆷	𫛾
糺	𫄙
䊺	𫄚
紟	𫄛
䋃	𫄜
𥾯	𫄝
䋔	𫄞
絁	𫄟
絙	𫄠
絧	𫄡
絥	𫄢
繷	𫄣
繨	𫄤
纚	𫄥
𦀖	𫄦
綖	𫄧
絺	𫄨
䋦	𫄩
𦅇	𫄪
綟	𫄫
緤	𫄬
緮	𫄭
䋼	𫄮
𦃩	𫄯
縍	𫄰
繬	𫄱
縸	𫄲
縰	𫄳
繂	𫄴
𦅈	𫄵
繈	繦	𫄶
繶	𫄷
纁	𫄸
纗	𫄹
鍊	錬	𫔀
鐼	𫔁
鍉	𫔂
𨰲	𫔃
鍒	𫔄
鎍	𫔅
䥯	𫔆
鎞	𫔇
鎙	𫔈
𨰃	𫔉
鏥	𫔊
䥗	𫔋
鏾	𫔌
鐇	𫔍
鐍	𫔎
𨬖	𫔏
𨭸	𫔐
𨭖	𫔑
𨮳	𫔒
𨯟	𫔓
鑴	𫔔
𨰥	𫔕
𨲳	𫔖
開	𫔭
閒	𫔮
閗	𫔯
閞	𫔰
𨴹	𫔲
閵	𫔴
䦯	𫔵
闑	𫔶
𨼳	𫔽
絍	𫟃
綋	𫟄
綡	𫟅
緟	𫟆
𦆲	𫟇
䖅	𫟑
䕤	𫟕
訨	𫟞
詊	𫟟
譂	𫟠
誴	𫟡
䜖	𫟢
䡐	𫟤
䡩	𫟥
䡵	𫟦
𨞺	𫟫
𨟊	𫟬
釚	𫟲
釲	𫟳
鈖	𫟴
鈗	𫟵
銏	𫟶
鉝	𫟷
鉽	𫟸
鉷	𫟹
䤤	𫟺
銂	𫟻
鐽	𫟼
𨧰	𫟽
𨩰	𫟾
鎈	𫟿
䫻	𫗇
𩗓	𫗈
𩗴	𫗉
䬓	𫗊
飋	𫗋
𩟗	𫗚
飦	𫗞
䬧	𫗟
餦	𫗠
𩚩	𫗡
飵	𫗢
飶	𫗣
𩛌	𫗤
餫	𫗥
餔	𫗦
餗	𫗧
𩛡	𫗨
饠	𫗩
餧	𫗪
餬	𫗫
餪	𫗬
餵	𫗭
餭	𫗮
餱	𫗯
䭔	𫗰
䭑	𫗱
𩝽	𫗳
饘	𫗴
饟	𫗵
釟	𫓥
釨	𫓦
鈇	𫓧
鈛	𫓨
鏦	𫓩
鈆	𫓪
𨥟	𫓫
鉔	𫓬
鉠	𫓭
𨪕	𫓮
銈	𫓯
銊	𫓰
鐈	𫓱
銁	𫓲
𨰋	𫓳
鉾	𫓴
鋠	𫓵
鋗	𫓶
𫒡	𫓷
錽	𫓸
錤	𫓹
鐪	𫓺
錜	𫓻
𨨛	𫓼
錝	𫓽
錥	𫓾
𨨢	𫓿
靧	𫖃
䪊	𫖅
鞾	𫖇
𩎖	𫖑
韠	𫖒
𩏂	𫖓
韛	𫖔
韝	𫖕
𩏠	𫖖
𩑔	𫖪
䪴	𫖫
䪾	𫖬
𩒎	𫖭
顗	𫖮
頫	𫖯
䫂	𫖰
䫀	𫖱
䫟	𫖲
頵	𫖳
𩔳	𫖴
𩓥	𫖵
顅	𫖶
𩔑	𫖷
願	𫖸
顣	𫖹
䫶	𫖺
鷐	𫜀
鷩	𫜁
𪅂	𫜂
鷣	𫜃
鷷	𫜄
䴋	𫜅
𪉸	𫜊
麷	𫜑
䴱	𫜒
𪌭	𫜓
䴽	𫜔
𪍠	𫜕
䵴	𫜙
𪓰	𫜟
䶕	𫜨
齩	𫜪
𫜦	𫜫
齰	𫜬
齭	𫜭
齴	𫜮
𪙏	𫜯
齾	𫜰
龓	𫜲
䶲	𫜳
軏	𫐄
軕	𫐅
轣	𫐆
軜	𫐇
軷	𫐈
軨	𫐉
軬	𫐊
𨎌	𫐋
𨌈	𫐍
輢	𫐎
輖	𫐏
輗	𫐐
輨	𫐑
輷	𫐒
輮	𫐓
𨍰	𫐔
轊	𫐕
轇	𫐖
轐	𫐗
轗	𫐘
轠	𫐙
遱	𫐷
馯	𫘛
馼	𫘜
駃	𫘝
駞	𫘞
駊	𫘟
駤	𫘠
駫	𫘡
駻	𫘣
騃	𫘤
騉	𫘥
騊	𫘦
騄	𫘧
騠	𫘨
騜	𫘩
騵	𫘪
騴	𫘫
騱	𫘬
騻	𫘭
䮰	𫘮
驓	𫘯
驙	𫘰
驨	𫘱
鬠	𫘽
䥄	𫠀
鑉	𫠁
閝	𫠂
韚	𫠅
頍	𫠆
𩖰	𫠇
䫾	𫠈
䮄	𫠊
騼	𫠋
𩦠	𫠌
𩵦	𫠏
魽	𫠐
䱸	𫠑
鱆	𫠒
𩿅	𫠖
齯	𫠜
𦠅	𫞅
潣	𫞗
澬	𫞚
㶆	𫞛
灍	𫞝
爧	𫞠
爃	𫞡
𤛱	𫞢
㹽	𫞣
珼	𫞥
璾	𫞦
𤩂	𫞧
璼	𫞨
璊	𫞩
𥢶	𫞷
豵	𫎆
貗	𫎌
贚	𫎦
䝭	𫎧
𧸘	𫎨
賝	𫎩
䞋	𫎪
贉	𫎫
贑	𫎬
䞓	𫎭
䟐	𫎱
䟆	𫎳
𧽯	𫎸
䟃	𫎺
㑮	𫝈
𠐊	𫝋
㛝	𫝦
㜐	𫝧
媈	𫝨
嬦	𫝩
𡟫	𫝪
婡	𫝫
嬇	𫝬
孆	𫝭
孄	𫝮
嶹	𫝵
襀	𫌀
襵	𫌇
𧞫	𫌋
覼	𫌨
覛	𫌪
𧡴	𫌫
𧢄	𫌬
覹	𫌭
䚩	𫌯
䠆	𫏃
蹳	𫏆
蹻	𫏋
𨂐	𫏌
蹔	𫏐
𨇽	𫏑
𨆪	𫏕
𨇰	𫏞
𨇤	𫏨
䆉	𫁂
竱	𫁟
鴗	𫁡
𥶽	𫁱
䉑	𫁲
𥯤	𫁳
䉶	𫁷
𥴼	𫁺
𦧺	𫇘
艣	𫇛
𦱌	𫇪
蔿	蒍	𫇭
蒭	𫇴
蕽	𫇽
蟂	𫋇
蟘	𫋌
䙔	𫋲
襗	𫋷
襓	𫋹
襘	𫋻
𥜰	𫀌
𥜐	𫀓
䅐	𫀨
䅳	𫀬
𥢷	𫀮
簢	𫂃
簂	𫂆
䉬	𫂈
𥴨	𫂖
𥻦	𫂿
䍤	𫅅
羵	𫅗
𦒀	𫅥
䎙	𫅭
𦔖	𫅼
䗅	𫊪
蠦	𫊮
蟜	𫊸
𧒯	𫊹
蟳	𫊻
蕳	𫈉
葝	𫈎
蔯	𫈟
蕝	𫈵
聻	𫆏
𦟼	𫆝
𦡝	𫆫
鄟	𫑘
鄳	𫑡
醶	𫑷
𩀨	𫕚
霣	𫕥
𩅙	𫕨
薆	𫉁
藷	𫉄	薯
䲰	𪉂
鳼	𪉃
𩿪	𪉄
𪀦	𪉅
鴲	𪉆
鴜	𪉈
𪁈	𪉉
鷨	𪉊
𪀾	𪉋
𪁖	𪉌
鵚	𪉍
𪂆	𪉎
𪃏	𪉏
𪃍	𪉐
鷔	𪉑
𪄕	𪉒
𪄆	𪉔
𪇳	𪉕
𧷎	𪠀
㓄	𪠟
𠬙	𪠡
唓	𪠳
㖮	𪠵
嚛	𪠸
𠽃	𪠺
噹	𪠽
㘓	𪢌
𡃤	𪢐
𡂡	𪢒
嚽	𪢕
𡅯	𪢖
囒	𪢠
圞	𪢮
墲	𪢸
嘺	𪡀
嘪	𪡃
噞	𪡋
嗹	𪡏
㗿	𪡛
嘳	𪡞
𡃄	𪡺
㞞	𪨊
屩	𪨗
崙	𪨧
𡸗	𪨩
輋	𪨶
巗	𪨷
𡹬	𪨹
𤘀	𪺣
𤜆	𪺪
犞	𪺭
獊	𪺷
𤠮	𪺸
㺜	𪺻
猌	𪺽
畼	𪽈
𤳷	𪽝
痮	𪽪
𤷃	𪽭
㿖	𪽮
𤺔	𪽴
瘱	𪽷
㟺	𪩇
巊	𪩎
巘	𪩘
𡿖	𪩛
幝	𪩷
幩	𪩸
𢯷	𪭝
摐	𪭢
擟	𪭧
𢶒	𪭯
掚	𪭵
撊	𪭾
䴬	𪎈
麲	𪎉
麨	𪎊
䴴	𪎋
麳	𪎌
廬	𪪏
㢗	𪪑
廧	𪪞
𢍰	𪪴
彃	𪪼
㨻	𪮃
㩋	𪮋
撧	𪮖
𢺳	𪮳
攋	𪮶
盨	𪾔
睍	𪾢
眝	𪾣
矑	𪾦
矉	𪾸
𧹈	𪥠
孇	𪥫
嬣	𪥰
嬻	𪥿
徿	𪫌
𢤩	𪫡
㦞	𪫷
憸	𪫺
櫅	𪲎
欐	𪲔
檵	𪲛
櫠	𪲮
𤑹	𪹀
𤓌	𪹠
爥	𪹳
𤒻	𪹹
瑽	𪻐
瓄	𪻨
瑻	𪻲
璝	𪻺
𥏝	𪿊
𥖲	𪿞
礮	𪿫
𥗇	𪿵
埬	𪣆
堚	𪣒
塿	𪣻
毊	𪵑
霼	𪵣
濿	𪵱
溡	𪶄
𤄷	𪶒
𣽏	𪶮
𪘀	𪚏
𪘯	𪚐
㔋	𪟎
勣	𪟝
𡓁	𪤄
壣	𪤚
孾	𪧀
寠	𪧘
𢣐	𪬚
𢤿	𪬯
膹	𪱥
梖	𪱷
欇	𪳍
𣜬	𪳗
㵾	𪷍
灒	𪷽
熂	𪸕
煇	𪸩
㻶	𪼋
𤬅	𪼴
𩡺	𩧦
駎	𩧨
𩤊	𩧩
䮾	𩧪
駚	𩧫
𩢡	𩧬
䭿	𩧭
𩢾	𩧮
驋	𩧯
䮝	𩧰
𩥉	𩧱
駧	𩧲
𩢸	𩧳
駩	𩧴
𩢴	𩧵
𩣏	𩧶
𩣫	𩧸
駶	𩧺
𩣵	𩧻
𩣺	𩧼
䮠	𩧿
騔	𩨀
䮞	𩨁
驄	𩨂
騝	𩨃
騪	𩨄
𩤸	𩨅
𩤙	𩨆
䮫	𩨇
騟	𩨈
𩤲	𩨉
騚	𩨊
𩥄	𩨋
𩥑	𩨌
𩥇	𩨍
龭	𩨎
䮳	𩨏
𩧆	𩨐
𩚥	𩠀
𩚵	𩠁
𩛆	𩠂
𩛩	𩠃
𩟐	𩠅
𩜦	𩠆
䭀	𩠇
䭃	𩠈
𩜇	𩠉
𩜵	𩠊
𩝔	𩠋
餸	𩠌
𩞄	𩠎
𩞦	𩠏
𩠴	𩠠
颰	𩙥
𩗀	𩙦
䬞	𩙧
𩘹	𩙨
𩘀	𩙩
颷	𩙪
颾	𩙫
𩘺	𩙬
𩘝	𩙭
䬘	𩙮
䬝	𩙯
𩙈	𩙰
鯄	𩾁
䲖	𩾂
鮸	𩾃
𩷰	𩾄
𩸃	𩾅
𩸦	𩾆
鯱	𩾇
䱙	𩾈
䱬	𩾊
䱰	𩾋
鱇	𩾌
𩽇	𩾎
魥	𩽹
𩵩	𩽺
𩵹	𩽻
鯶	𩽼
𩶱	𩽽
鮟	𩽾
𩶰	𩽿
䪏	𩏼
𩏪	𩏽
𩎢	𩏾
䪘	𩏿
𩓣	𩖕
顃	𩖖
䫴	𩖗
𩭙	𩬣
𩰀	𩬤
𨥛	𨱀
鈠	𨱁
鈋	𨱂
鈲	𨱃
鈯	𨱄
鉁	𨱅
龯	𨱆
銶	𨱇
鋉	𨱈
鍄	𨱉
𨧱	𨱊
錂	𨱋
鏆	𨱌
鎯	𨱍
鍮	𨱎
鎝	𨱏
𨫒	𨱐
鐄	𨱑
鏉	𨱒
鐎	𨱓
鐏	𨱔
𨮂	𨱕
䥩	𨱖
𨳕	𨸀
𨳑	𨸁
閍	𨸂
閐	𨸃
䦘	𨸄
𨴗	𨸅
𨵩	𨸆
𨵸	𨸇
𨶀	𨸉
𨶏	𨸊
𨶲	𨸋
𨶮	𨸌
𨷲	𨸎
𨽏	𨸘
䧢	𨸟
軗	𨐅
𨊻	𨐆
𨏠	𨐇
輄	𨐈
𨎮	𨐉
𨏥	𨐊
䠱	𨅛
𨇞	𨅫
躝	𨅬
躘	𨀁
𨄣	𨀱
𨢿	𨡙
𨣈	𨡺
鎷	𨰾
釳	𨰿
㯤	𣘐
𣞻	𣘓
檭	𣘴
𣝕	𣘷
𦢈	𣍨
腪	𣍯
脥	𣍰
樠	𣗊
欓	𣗋
㰙	𣗙
澅	𣶩
𣿉	𣶫
𪷓	𣶭
桱	𣐕
欍	𣐤
湋	𣲗
潕	𣲘
灙	𣺼
𤁣	𣺽
𥿊	𦈈
緷	𦈉
綇	𦈋
綀	𦈌
繟	𦈎
緍	𦈏
縺	𦈐
緸	𦈑
𦂅	𦈒
䋿	𦈓
縎	𦈔
緰	𦈕
䌈	𦈖
𦃄	𦈗
䌋	𦈘
䌰	𦈙
縬	𦈚
繓	𦈛
䌖	𦈜
繏	𦈝
䌟	𦈞
䌝	𦈟
䌥	𦈠
繻	𦈡
蓧	𦰏
䕳	𦰴
爇	𦶟
𦾟	𦶻
爄	𤇃
熌	𤇄
爖	𤇭
熚	𤇹
熓	𤆡
㷍	𤆢
熉	𤈶
㷿	𤈷
𤒎	𤊀
𤓩	𤊰
𤓎	𤎺
𤑳	㸇	𤎻
獩	𤞃
玁	𤞤
癐	𤶊
𤸫	𤶧
礒	𥐟
𥖅	𥐯
𥕥	𥐰
碙	𥐻
𥌃	𥅘
䀹	𥅴
𥊝	𥅿
䉙	𥬀
籋	𥬞
篘	𥬠
𥸠	𥮋
䉲	𥮜
篸	𥮾
竚	𥩟
𥪂	𥩺
䊭	𥺅
𥽖	𥺇
剾	𠛅
𠞆	𠛆
𪟖	𠛾
儣	𠆲
𠌥	𠆿
㒓	𠉂
𠏢	𠉗
哯	𠯟
噅	𠯠
㘉	𠰱
嚧	𠰷
𡃕	𠴛
𡄔	𠴢
𡄣	𠵸
㗲	𠵾
愻	𢙏
憹	𢙐
𢠼	𢙑
憢	𢙒
懀	𢙓
𢤱	𢘙
𢣚	𢘝
𢣭	𢘞
𢷮	𢫊
𢶫	𢫞
摋	𢫬
擫	𢬍
𢹿	𢬦
䞈	𧹑
買	𧹒
𧶔	𧹓
賬	𧹔
䝻	𧹕
賟	𧹖
贃	𧹗
𧕟	𧉐
䗿	𧉞
蠙	𧏖
蠀	𧏗
襰	𧝝
𧟀	𧝧
𡓾	𡋀
𡑭	𡋗
壗	𡋤
㜗	𡞋
㜢	𡞱
𡮉	𡭜
𡮣	𡭬
𡳳	𡳃
𦘧	𡳒
嶈	𡺃
嶘	𡺄
𨧀	𬭊
𨨏	𬭛
𨭎	𬭳
𨭆	𬭶
錀	𬬭
鑪	𬬻
𪈼	𱊜
僤	𫢸
㘔	𫬐
墠	𫮃
娙	𫰛
嵽	𫶇
廞	𫷷
彄	𫸩
暐	𬀩
繐	𰬸
菕	𰰨
譅	𰶎
𣍐	𫧃
𪋿	𫧮
鏚	𬭭
鮈	𬶋
鮀	𬶍
鮠	𬶏
鯻	𬶟
鷭	𬸪
鷿	𬸯
鋂	𰾄
鑀	𰾭
